1011000111
1001110101
1111000111
1000100101
1001011111
1111100010
0011111011
1110001101
1011111101
0101000111