0000111000
0110001010
0110111000
0110011010
0110100000
0100111101
0101001000
0001011010
0100001010
0111100000