13111111111111
10100010000101
10101010111101
10101010101101
10111010001001
10000000101101
10101010101001
10101010100001
10101011111101
10100000100011
10101110101001
10000010111101
11111110101101
10100000101001
10101010000011
10101111111001
10001000000011
11111211111111
